------------------------------------------------------------------------------------------------------------------------------------------------------------------------------------------------
------------------------------------------------------------------------------------------------------------------------------------------------------------------------------------------------
------------------------------------------------------------------------------------------------------------------------------------------------------------------------------------------------
-----------------------------------------------------------------------------------B?B------------------------------------------------------------------------------------------------##--------
--------------------------------------------------------------------------------------------------------------------------------------------------------------------------------------##--------
-----------------------------------------------------------------------------------------------------------------------------------------------------pP-------------------------------##--------
-----------------------------------------------------------------------------------------------------------------------------------------------------pP----------------------------#--##--------
----------------------------------------------------------------------------------#####-----------------------------------------------------#?BB-----##---------------------------##--##--------
-------------------------------------pP-----pP----e-------------------------e-----#--------------------------#------------------------------#--------------------------------e---###--##--------
-------------------------------------pP-----pP------------------------------------#---------------------c----#------------------------------#-----------c---pP-----c-----e------####------------
---------e--ee-e------ee-e----e------pP-----pP----------e-ee-----e-ee-------------#------------e-ee-----c----#--e-ee---e-------e---------ee-#-----------c---pP-----c-----------#####------------
##########################################--#########################################----##################--####################################---############################################
