----------------e-----------------------------------------------------------------------------------------------------------------------------------------------------------------------------------------------
--------------e-------------------------------------------------------------------------------------------------------------------------------------------------------------------------------------------------
----------------------------------------------------------------------------------------------------------------------------------------------------------------------------------------------------------------
-----------------##-----------------B?BBBBBBBBBBBBBBBBBBBBBBBBBBBBBBB------------------------------------------------------------------------------------------------------------------------------e---##-------
----------------###------------------------------------------------------------------------------------------------------------------------------------------------------------------------------------##-------
---------------####------------------------------------------------------------------------------------------------------------------------------------------------------------------------------------##-------
---------------####---------------------------------------------------------------------------------------------c-----------------------------------------------------------------e#----------------#--##-------
-------------#-####---????--------------------------------------------BB--------------------B?---------BB------B#?-----------------------------------pP---------------e-----------##----------------#--##-------
--------e---##-####----------------------------e---------e---e------------------------c-------------------------------c-----------e------------------pP---------e----------------###----c---------#-#--##-------
-----------###-####-----------------------------------------------------------c----e--ce----------c-------------------c-----pP---------pP------------pP-----pP----e-----c------e####----c--------##-#--##-------
----------####-####-----------------------------------------------------------c-------c-----------c--e------c--e-e----c-----pP---------pP------------pP-----pP----------c------#####-e--c-------###-#--##-------
########-#####-##############-########-####-#-###-######-##############--####-#####################################################-#####-#-#------####################-#---#######################-#--#########
