--------------------------------------------------------------------------------------------------------------------------------------------------------------------------------------------------------------------------------------------------------------------------------------------------------------------------------------------------------------------------------
--------------------------------------------------------------------------------------------------------------------------------------------------------------------------------------------------------------------------------------------------------------------------------------------------------------------------------------------------------------------------------
--------------------------------------------------------------------------------------------------------------------------------------------------------------------------------------------------------------------------------------------------------------------------------------------------------------------------------------------------------------------------------
---------------------------------------------------------------------------------------------------------------------------------------------------BBBB?BBB------------------------------------------------------------------------------------------------------------------------------------------------------------------------------------------------------------##-------
-----------------------------------------------------------------------------------------------------------------------------------------------------------------------------------------------------------------------------------------------------------------------------------------------------------------------------------------------------------------------##-------
---------------------------------------------------------------------------------------------------------------------------------------------------------------------------------------------------------------------------------------------------------------------------------#-----------------------------------------------------------------------------------#-##-------
-------------------------------------------------------------------------?-------------------------------------------------------------------------------------------------------BB?BBBBB------------------------------------------------------pP-------------------------------##-----------------------------------------------------------------------------------#-##-------
----------------------------pP---------------------------------------pP----------------pP--------pP-----------------------------------------------#----?----#------------------------------------------------------------------------------pP--pP------------------------------###---------------------------------------------------------------------------------#-#-##-------
----------------------------pP---------------------------------------pP----pP----------pP--------pP----------------------------------pP-----------#-----e---#------e-------------------------------------------------------------------pP--pP--pP-----------------------------####---------------------------------------------------------------pP----------------#-#-##-------
----------------------------pP---------------------------------------pP----pP----------pP--------pP---------pP-----------------------pP-----------#---------#-----------e----------------------------------#---------------------------pP--pP--pP----------------------------#####----------------------#---#------------------------------------pP---------pP---#-#-#-##-------
-------e------ee-e------e---pP----e-e--------------e---------ee-e----pP--e-pP----------pP-e-ee---pP---------pPe------e----e-ee-------pP-----ee-e--#---------#-----------------------------------------e-e--#--------------------ee-e---pP--pP--pP---e---e-ee---e--------e---######-e--------------------#e--#-----------------------e------ee-e--pP---------pP---#-#-#-##-------
#######################################-#-##-##-##-###############################################################################################################-#-##-#-##-#################-#-#-###################------##########-##--##--############################################---##---################-----#----###################################-#-#-#-#########
