--------------------------------------------------------------------------------------------------------------------------------------------------------------------------------------------
--------------------------------------------------------------------------------------------------------------------------------------------------------------------------------------------
---------------------------------------------------------------------------e--e-------------------------------------------------------------------------------------------------------------
---------------?---------------------------------------------------------BBBBBBBB---BBB?--------------?-----------BBB----B??B--------------------------------------------------------##-----
------------------------------------------------------------------------------------------------------------------------------------------------------------------------------------###-----
-----------------------------------------------------------------------------------------------------------------------------------------------------------------------------------####-----
---------------------------------------------------------?------------------------------------------------------------------------------------------------------------------------#####-----
---------?---B?B?B---------------------pP---------pP------------------B?B--------------B-----B?----?--?--?-----B----------BB------#--#----------##--#------------BB?B------------######-----
-------------------------------pP------pP---------pP-----------------------------------------------------------------------------##--##--------###--##--------------------------#######-----
---------------------pP--------pP------pP---------pP----------------------------------------------------------------------------###--###------####--###-----pP--------------pP-########-----
--------------e------pP--------pPe-----pP----ee---pP------------------------------------ee---------e-----------------ee-ee-----####--####----#####--####----pP--------ee----pP#########-----
##############################################################--###############---################################################################--########################################
