--------------------------------------------------------------------------------------------------------------------------------------------------------------------------------
-------------------------e------------------------------------------------------------------------------------------------------------------------------------------------------
--------------------------------------------------------------------------------------------------------------------------------------------------------------------------------
-----------------------------?B---------------------------------------------------------------------------?--------------------------------------------------------------##-----
----------------------------------------------------------------------------------#BBB-----------------------------------------------------------------------------------##-----
---------------------------------------------------------------------------------##----------------------------------------------------------#BB-------------------------##-----
--------------------------------------------------------------------------------###?-----------------------------------#BB-??---------------##------------------------#--##-----
---------??-----------------###---BB?----------------------------##-------------###-----------------------?-----------##-------------------###--B?-------------------##--##-----
--------------------------###-----------------------------------###-----------#-###--BBB-------pP--------------------###------------------####----------------------###--##-----
----------------------#####------------------------------------####----------##-###------------pP-------------------####-----------------#####---BBB---------------####--##-----
-------------------######-------------------------------------#####-------------###------------pP------------------#####---BBBBB--------######--------------------#####--##-----
#############--#########------##--################--###############---################---###############################-------##-############------#########---#######--#######
