------------------------------------------------------------------------------------------------------------------------------------------------------------------------------------------------
------------------------------------------------------------------------------------------------------------------------------------------------------------------------------------------------
------------------------------------------------------------------------------------------------------------------e----------------------------------e------------------------------------------
----------------------BBBBB?--------------------------------------------------?BB------------------------------BBBBBBB?---------------------------BBBBB--------------BBBB--------------##-------
-----------------------------------------------------------------------------------------------------------------------------------------------------------------------------------e--###-------
----------c---------------------------------------------------##----------------------------------------------------------------------------------------------------------------------###-------
----------c--------------------------------------------------###----------e-------BBB-------------------------------e---------------------------------------------------------------#-###-------
--------####----------BBBBBB-----------e##----------------#--###-------?????-?---------------------------------BBBBBBBB---------------------BBB------------------?-----------------##-###-------
-------##----------------------e-------###------pP------e##--###----------------------------------e-----------------------#----------------------------------ee--------------------##-###-------
------###-----------------------------#####-----pP------###--###------------------------------------c-------pP------------#-----------??------------------------------pP---------#-##-###-------
-----####----e-----------------------######-----pP---e-####--###------------------------------------c-------pP------------#----eee-----------------ee-----------------pP--------##-##-###-------
###################---#####################################--########################----###############################--###############-------###################---##--########-##-##########
