-------------------------------------------------------------------------------------------------------------------------------------------------?--------------------------
----------------------------------------------------------------------------------------------------------------------------------------------------------------------------
-------------------------------------------------------------------------------e--------------------------------------------------------------------------------------------
--------------------?BB----------------------------------------------------BBBBBBB----?----------------------------------------BBBBB------------------------------##--------
--------------------------------------------------------------------------------------------------------------------------------------------------BB------------e###--------
---------------------------------------------------------e---------------------------------------------------------------------------------------------#--------####--------
---------------------------------------------------------e-------------------e--------------------------------------------------e-------------BB------##-------#####--------
----------------e---------------????-------------------BB#?B---------------BBBBBBB---------------------------------------------BBBBB-----------------###------######--------
---------------------c-----------------c----------c------------------pP---------------pP--------------pP------------------------------#----c--------####-----#######--------
-------------c-------c-------c-e-------c----e-----c----------c-------pP---------------pP----------c---pP----pP-----c-----pP-----------#----c-------#####----########--------
-------------c-------c-------c---------c----------c----------c-------pP---------------pP----------c---pPe---pP-----c-----pP-------e---#----c------######---#########--------
##################################################################--#############################################################################-##########################
