------------------------------------------------------------------------------------------------------------------------------------------------------------------------------------
------------------------------------------------------------------------------------------------------------------------------------------------------------------------------------
------------------------------------------------------------------------------------------------------------------------------------------------------------------------------------
---------------------?BBB---------------------?????-----------?BBB--------BB?BB------BBBB-----------------------------?BBB-----------------------------------BBBBB---?--------------
------------------------------------------------------------------------------------------------------------------------------------------------------------------------------------
------------------------------------------------------------------------------------------------------------------------------------------------------------------------------------
-----------------#----------------------------e----------------------------------------------------------------------------pP-------------------------------------------------------
--------B?B----e##---?-----#-----------pP-----?????----------B-----pP---????--???---------------pP-----------------pP------pP-----------------------------?---e----?--------------BB
---------------###---------#-----------pP--------------------------pP---------------------------pP-----------------pP--pP--pP----------------------#--------------e------pP---------
--------------####---------##----------pP--------------------------pP---------------------------pP----------pP-----pP--pP--pP----------------------#---------------------pP---------
-------------#####---e-e---##--ee------pP-----------ee---e-ee-e----pP-------ee-e------------e---pP--------e-pP--e--pP--pP--pP-----------------e----#-----ee--------------pPe--------
#####################################################################################----##########---##############################---##########--#################################
